{
  "id": "dead_end",
  "name": "Dead End Maze",
  "width": 10,
  "height": 10,
  "grid": [
    [1, 1, 1, 1, 1, 1, 1, 1, 1, 1],
    [1, 0, 0, 0, 1, 0, 0, 0, 0, 1],
    [1, 0, 1, 0, 1, 0, 1, 1, 0, 1],
    [1, 0, 1, 0, 0, 0, 0, 1, 0, 1],
    [1, 0, 1, 1, 1, 1, 0, 1, 0, 1],
    [1, 0, 0, 0, 0, 1, 0, 0, 0, 1],
    [1, 1, 1, 1, 0, 1, 1, 1, 0, 1],
    [1, 0, 0, 0, 0, 0, 0, 1, 0, 1],
    [1, 0, 1, 1, 1, 1, 0, 1, 4, 1],
    [1, 1, 1, 1, 1, 1, 1, 1, 1, 1]
  ],
  "agentStart": [1, 1]
}
