##########
#A# #    #
# # # ## #
# #   #  #
# ### # ##
#   # #  #
## ## ## #
#     #  #
# ###  G #
##########