##########
#A  #    #
#   #    #
#   #    #
#   D    #
#   #    #
# K #    #
#   #    #
#   #   G#
##########