{
  "id": "four_rooms",
  "name": "Four Rooms",
  "width": 10,
  "height": 10,
  "grid": [
    [1, 1, 1, 1, 1, 1, 1, 1, 1, 1],
    [1, 0, 4, 0, 2, 0, 0, 0, 0, 1],
    [1, 0, 0, 0, 2, 0, 0, 3, 0, 1],
    [1, 0, 0, 0, 2, 0, 0, 0, 0, 1],
    [1, 0, 0, 0, 2, 0, 0, 3, 0, 1],
    [1, 1, 1, 2, 1, 1, 2, 1, 1, 1],
    [1, 0, 0, 0, 2, 0, 0, 0, 0, 1],
    [1, 0, 0, 0, 2, 0, 0, 0, 0, 1],
    [1, 0, 0, 3, 2, 0, 0, 0, 0, 1],
    [1, 1, 1, 1, 1, 1, 1, 1, 1, 1]
  ],
  "agentStart": [6, 1]
}
