{
  "id": "key_puzzle",
  "name": "Key Puzzle",
  "width": 10,
  "height": 10,
  "grid": [
    [1, 1, 1, 1, 1, 1, 1, 1, 1, 1],
    [1, 0, 0, 0, 0, 1, 0, 0, 4, 1],
    [1, 0, 0, 0, 0, 1, 0, 0, 0, 1],
    [1, 0, 0, 0, 0, 1, 0, 0, 0, 1],
    [1, 0, 0, 0, 0, 2, 0, 0, 0, 1],
    [1, 0, 0, 0, 0, 1, 0, 0, 0, 1],
    [1, 0, 0, 0, 0, 1, 1, 1, 1, 1],
    [1, 0, 0, 0, 0, 0, 0, 0, 0, 1],
    [1, 0, 0, 3, 0, 0, 0, 0, 0, 1],
    [1, 1, 1, 1, 1, 1, 1, 1, 1, 1]
  ],
  "agentStart": [1, 1]
}
