##########
#A  #    #
### #    #
#   #    #
# K #    #
#   D    #
#   #    #
#   # ~~ #
#   # ~G #
##########