{
  "id": "lava_crossing",
  "name": "Lava Crossing",
  "width": 10,
  "height": 10,
  "grid": [
    [1, 1, 1, 1, 1, 1, 1, 1, 1, 1],
    [1, 0, 0, 0, 0, 0, 0, 0, 0, 1],
    [1, 0, 0, 0, 0, 0, 0, 0, 0, 1],
    [1, 0, 0, 0, 0, 0, 0, 0, 0, 1],
    [1, 5, 5, 5, 0, 5, 5, 5, 5, 1],
    [1, 0, 0, 0, 0, 0, 0, 0, 0, 1],
    [1, 0, 0, 0, 0, 0, 0, 0, 0, 1],
    [1, 0, 0, 0, 0, 0, 0, 0, 0, 1],
    [1, 0, 0, 0, 0, 0, 0, 0, 4, 1],
    [1, 1, 1, 1, 1, 1, 1, 1, 1, 1]
  ],
  "agentStart": [1, 1]
}
