{
  "id": "lava_maze",
  "name": "Lava Maze",
  "width": 10,
  "height": 10,
  "grid": [
    [1, 1, 1, 1, 1, 1, 1, 1, 1, 1],
    [1, 0, 0, 0, 5, 0, 0, 0, 0, 1],
    [1, 0, 1, 0, 5, 0, 1, 5, 0, 1],
    [1, 0, 1, 0, 0, 0, 1, 5, 0, 1],
    [1, 0, 1, 1, 1, 0, 1, 0, 0, 1],
    [1, 0, 0, 0, 0, 0, 5, 0, 0, 1],
    [1, 5, 5, 5, 0, 1, 1, 1, 0, 1],
    [1, 0, 0, 0, 0, 0, 0, 0, 0, 1],
    [1, 0, 5, 5, 5, 0, 0, 0, 4, 1],
    [1, 1, 1, 1, 1, 1, 1, 1, 1, 1]
  ],
  "agentStart": [1, 1]
}
