##########
#A       #
#        #
#        #
#~~~ ~~~~#
#        #
#        #
#        #
#       G#
##########