##########
#A       #
#        #
#        #
###K# ####
#   #    #
#   D    #
#   #    #
#   #   G#
##########