##########
#A       #
######## #
#        #
# ########
#        #
######## #
#        #
#G       #
##########