##########
#A K     #
####D#####
#  K     #
####D#####
#K       #
####D#####
#        #
#       G#
##########