##########
#A  K    #
#        #
#        #
####D#####
#    K   #
#        #
####D#####
#       G#
##########