##########
#A       #
#        #
#        #
#  K     #
#####D####
#        #
#        #
#       G#
##########