##########
#A       #
# ~~~~~  #
#      ~ #
# ~~~~~ ~#
#        #
#~ ~~~~~~#
#        #
#       G#
##########